##....##
#......#
#......#
..#..#..
..#@.#..
#......#
#......#
##....##